11...111...111...11
1.................1
...................
...DDD..DDD..DDD...
...DDD..DDD..DDD...
1..DDD..DDD..DDD..1
1.................1
1.................1
...DDD..DDD..DDD...
...DDD..DDD..DDD...
...DDD..DDD..DDD...
1.................1
1.........P.......1
1..DDD..DDD..DDD..1
...DDD..DDD..DDD...
...DDD..DDD..DDD...
...................
1.................1
11...111...111...11
